#Example: Large parts of Africa and south east Asia
arid = {
	632 633 634 635 539 535 537 631 538 532 541 540 542 543 536 544 545 551 553 556 596 555
	566 594 595 565 572 558 561 564 574 581 590 593 592 585 573 591 586 584 601 602 627
	716 717 715 718 719 712 711 1641 1640 1639 725 726 724 723 720 721 722 710 708 698 699 697 695 696
	660 663 658 659 713 661 666 656 657 662 654 694 651 653 655 665 647
	641 645 644 642 664 639 640 628 643 678 677 679 796 906 675 674 676 686 685 693 689 690 691 692
	700 703 702 727 733 787 786 788 789 790  792 791 793 794 3229 749 743 2252 2251 770 
	754 753 2249 756 755 760 757 758 761 759 762 763 780 781 785 783 795 782 778 777 779 776 775
	784 774 764 766 765 772 773 767 768 769 803 804 801 802 805 807 808 806 809 811 812 810 813 815 814
	821 818 817 819 816 830 820 829 828 823 822 824 825 826 848 849 844 845 846 839 841 843 840 842 
	831 827 855 834 835 836 837 929 838 860 861 847 832 833 2255 2254 2259 2258 2256 2260 2261 2257
	2529 2533 2534 2532 2530 2265 2262 2264 2276 2263 2270 2269 2268 2296 2524 2297
	2520 2521 2522 2545 2546 2519 2528 2523 2579 2580 2540 2536 2531 2547 2548 2538 2535 2537 2539 2714 
	2543 2544 2542 2541 2550 2552 2553 2549 2551 2555 2248 2525 2526 2313 2323 2351 2352 
	2366 2367 2364 2353 2354 2374 2480 3227 3228 2361 2360 2362 2363 2356 2357 2358 2514 2511 2510 2513 2359
	2517 2515 2512 2573 2564 2574 2575 2577 2587 2576 2578 2630 2629 2581 2589 2588 2583 2582 2584 2586
	2650 2649 2651 2648 2642 2637 2643 2638 2634 2635 2636 2633 2632 2603 2604 2625 2602 2601
	2622 2628 2623 2626 2621 2612 2605 2620 2609 2607 2608 2606 2572 2567 2562 2568 2569 2570 2561 
	2557 2556 2554 2558 2559 2565 2563 2560 3237 2253
	2715 2747 2727 2750 2742 2744 2743 2741 2761 2815 2712 2740 2722 2745
	2726 2749 2771 2770 2762 2791 2813 2814 2778 2787 2767 2780 2781 2779 2769
	2777 2776 2775 2792 2786 2785 2768 2766 2763 2838
	2884 2881 2887 2882 2885 2888 2901 2902 2886 2899 2870 2867 2889 2837 2836 2868 2874 2923 2955 2926 2952  
	892 894 893 891 890 889 887 886 884 2312 2309 2294 888 1162 1161 3256 3258 3259 3260 3257 3261 3262 3263
	925 3264 3265 3272 3300 3294 3293 3292 3302 3303 3304 3318 3305 3308 3306 3307 3309  3314 3326 3327 3328  
	3320 3319 3321 3322 3330 3323 3324 3325 3310 3313 3315 3329 3316 3353 4572 4573 4574 4575 4576 4577 4578
	4571 3383 3384 3385 3386 3382 3376 3375 3373 3372 3371 3370 3368 3363 3390 3391 3392 3398 4143 4140 4158 
	4159 4144 4146 4160 4153 4157 4154 4569 4142 4145 4134 3424 3425 3426 3427 3431 3430 3437 3438 3432 3433
	3434 3435 3436 3423 3422 3525 3531
	3844 3848 3867 3870 3871 3866 3865 3869 3839 3841 3840 3836 3834 3835 3842 3843 3852 3853 3829 3830 3849 3854 3850 3851 3862
	3860 3861 3863 3864 4743 4744 4748 4749 4756 4757 4758 4764 4765 4766 4767 4768 4769 4770 4771 4772
	4944 4945 4946 4947 4948 4745
	4954 4955 4956 4957 4958 4962 4963 4969 4970 4971 4972 4973 5045 5046 5047 5048 5052 5064 5072 5073 5149 5150
	5168 5169 5170 5171 5172 5173 5174 5175 5176 5177 5178 5179 5180 5181 5182 5183 5184 5196 5198 5199 5200 5201 5202 5203 5204 5205
	5206 5207 5208 5209 5210 5211 5212 5213 5214 5215 5218 5219 5231 5232 5233 5234 5235 5259 5260 5261 5267 5268 5269 5270 5271
	6242 6253
}

arctic = {
	4708 4706 4707 4705 4704 4654 4655 4657 4656 4658 4666 4664 4668 4667 4665 4661 4660 4659 4662 4663 4669 4671 4670 4673 4672 4701 4700 4699 4702 4703
	4675 4674 4676 4677 4678 4680 4682 4679 4681 4683 4684 4685 4686 4687 4688 4690 4689 4691 4692 4693 4694 4695 4696 4697 4698
	4719 4718 4715 4717 4716 4713 4712 4710 4711 4709
	3358 3357 3356 3355 3354
	5304 5305 5306 5307 5308 5309 5310 5311 5312 5313 5314 5315 5316 5317 5318 5319
}

mild_winter = {
	355 356 358 354 353 352 351 350 303 304 277 278 279 280 281 283 284 282 286 287 289 290 291 292 2114
	1819 1818 1817 1814 1815 1816 1810 1813 1809 1781 1754 1753 1750 1748 1747 1744 1745 1743 1742 1746
	490 491 494 493 489 486 484 483 482 478 455 457 448 450 449 456 458 447 452 444 445 443 442 441 446 
	242 241 239 221 204 222 203 223 227 228 231 233 201 198 187 207 167 212 165 211 214 216 245 246 215
	248 251 396 398 399 372 371 366 98 101 102 103 104 88 89 107 114 108 87 84 65 76 64 61 54 46 40 36 
	30 27 122 266 123 126 125 127 118 1167 1164 1163 1157 1158 1156 1150 1147 1142 1046 1043 1040 1037 
	1009 1029 1032 1027 1061 1072 1018 1014 968 1021 947 948 946 943 1111 1117 1112 1091 1092 1938 1943
	1106 1107 1103 1104 1105 1945 1102 1099 1984 1098 2229 2228 2227 2225 2223 2183 2182 2180 2196 2192
	2219 2213 2214 2210 2211 2189 2194 2195 2198 2177 2173 2168 2174 2176 2201 2204 2209 2336 2338 2167
	2701 2704 2705 2730 2729 2706 2728 2760 2751 2724 2725 2755 2732 2735 2734 2683 2682 2685 2496 
	2708 2664 2327 2197 2212 2861 2865 2853 2892 2890 2911 2910 2909
	2908 2907 2905 2107 1983 2098 2094 2099 2100 2093 2101 2102 2091 2090 2092 3232 451 453 454 459 435 
	433 431 437 436 439 440 438 420 419 406 415 267 2056 2050 2044 2045 2038 2039 1981 3230 2035 2033 
	2034 1977 1978 1974 1972 2020 2018 1964 2016 2017 2019 2007 3231 2005 1998 1999 1997 2816 2806
	2831 2810 2826 62 418 417 407 408 414 413 2466 2468 2465 2403 1976 2037 2006 2008
	2009 2010 2011 2012 2013 83 86 97 93 58 41 3212 2154 2161 2190 2179 2178 2170 2169
	2883 2841 2746 2722 2745 2726 2765 2764 2839 2830 2828 2829 2856 2857 2869 2864 2817 2854 2754 
	2733 3252 3345 3346 3318 3303 3304 3306 3307 3309 3310 3313 3314 3319 3320 3321 3322
	3330 3323 3324 3326 3327 3328 4576 3410 3316 3372 3375 3413 3376 3382 3387 3388 3392 3391 
	3398 3353 3325 4578 4575 4574 4577 4573 4572 4571 4569 
	4384 4402 4470 4474 4476 4477 4479 4484 4487 4490 4491 4492 4493 4502 4463 4464 4465 4478 
	4460 4461 4466 4475 4483 4469 4468 4473 4471 4482 4497 4509 4498 4496 4400 4421 4418 4410
	4422 4409 4338 4337 4327 4317 4297 4305 4302 4273 4262 4259 4267 4608 4268 4256 4108 
	4107 4252 4486 4253 4255 4254 4258 4257 4266 4264 4270 4303 4315 4298 4299 4329 4328 4407 
	4420 4417 4424 4413 4416 4414 4506 4489 4548 4540 4561 4564 4566 4542 4263 4304 4480 3431
	3430 3427 3426 3425 3424 3436 3435 3423 4734 2665 2175
	3872 3846 3699 3875 3874 3873 4756 5074 5075 5076 3244
	4728 4729 4724 4723 4737 4753 4754 4755 4758 4759 4760 4761 4762 4773 4781 4789 4790 4791
	4804 4805 4806 4807 4815 4818 2188 5735 3234 3415 3411 3390 3386 3385 3384 3383
	4949 4952 4959 4960 4961 4964 4965 4966 4967 4968 4972 4973 4775 4778 2707 4814 2709 4801 4803 2681 4802 2680
	4976 4733 4732 4979 4980 4981 4982 4983 4987 4988 5004 5005
	5009 5010 5011 5012 5132 5133 5134 5135 5136 5137 4774 5185 5186 5187 5188 5189 5190 5191 5193
	5216 5217 5221 5222 5223 5224 5225 5236 5237 5238 5239 5255 5256 5257 5258 5272 5273 5274 5275 5276 5277 5278 5279 5280 5281
	5282 5283 5284 5285 5286 5287 5288 5289 5290 5291 5292 5293 5294 5295 5297 5298 5325 5502 5503
	5522 5531 5532 5534 5535 5539 5543 5544 5702 5706 5710 5711 5714 5715 5716 5719 5720 5721 5722 5723 5724
	5725 5726 5728 5729 5736 5737 5740 5741 5742 5743 5744 5745 5746 5747 5748 5749 5751 5752 5754 5755 5756 5761 5762 5296 5220
	5777 5778 5782 5785 5800 5801 5802 5803 5804 5805 5806 5807 5814 5815 5816 5817 5818 5825 5829 5838 5843 5844 5845 5863
	#New Europe
	2097 2077 2096 2079 2078 2076 2103 2105 2104 2110 2111 2106 2109 2108 2904 2903 5218 2901 2902 2065 2066 2095 2067 2069 2068
	2070 2071 2072 2004 2003 2002 2001 2000 1996 1995 1994 1993 1992 1991 1990 1989 1988 1986 1987 1985 1097 1100 1096 1101 1095
	5842 5841 1094 5840 1093 5839 1090 1089 1113 1083 5828 1114 1088 210 200 194 188 186 185 169 168 166 158 155 154 153 152 259
	149 147 144 148 257 148 170 184 171 183 182 172 180 181 143 142 116 109 85 82 1144 1140 1146 1152 1155 1165 1166 1139 1136 1047
	6239 6241
	#Korea
	5940 5957 5959 5960 5961 6002 6003 6005 6009 6008 6011 6010 6006 6004 5964 5963 5958 5956 5944 5943 5941 5942 5945 5946
	5955 5965 6017 6016 6014 6012 6013 6015 6022 6018 6020 5966 5967 5968 5954 5953 5947 5975 5970 5969 5972
	6029 6028 6030 6024 6023 6019 6021 5971 5973 5974 5976 5994 5993 5996 5995 6044
	6043 6041 6025 6026 6027 6031 6042 5962 1711 6007 5977 5980 5981 5978 5979 5988 5989 5990 5992 6051 6055 6052 6053 6054 5997 6046
	6049 6050 6048 6047 6045 1712 6039 6040 6038 6037 6036 6034 6033 6035 6032 3223
	#New Middle East
	2302 2295 2301 2298 5621 5620 2288 2289 5619 5618 5616 5617 2286 5612 2284 2290 2282 2280 2283 5615 2277 3444 5613 2278 5614 4886
	2306 2308 2310 3448 4889 2319 2318 3446 3447 4899 2326 4898 2349 4897 2348 2329 2345 2346 2331 4935 2339 4934 3992 4933 2344 2371
	3439 2372 2370 4896 3991 2376 3441 4855 3442 2387 2471 4859 3450 3451 3452 3453 2477 4880 2481 2475 2474 3990 2384 4858 4857 4930
	4856 2377 2166 5738 2164 3243 5739 2165 2159 5704 5734 5703 2156 2148 5707 2153 2335 5784 2337 2322 4881 2293 4891 2292 4854 2670
	4943 3469 3466 2663 3465 3463 2658 3460 3461 2657 2653 2655 5627 4852 2490 4853 2487 4878 2485 4879 2484 4877 2486 4876 3989 2478
	2476 3982 3471 4939 2639 2647 2644 2624 2610 2609 2611 2614 2615 2616 2618 2613 2627 2617 2619 2621 2626
	#New Iran
	2716 2713 2717 3856 3857 2748 2782 3855 6146
	5053 2840 5054 4751 5055 5049 4752 5230 5197 5192 5229 5228 5226 5194 5227 2721 4747 5035 5020 5019 2845 5021 2846 5023 5034 5028
	5025 5022 5037 5024 5038 5029 5036 5026 4746 5027 5008 5007 4977 4731 4978 5006 5039 4975 2832 5040 4974 4735 4736 5041 2834 5043
	2833 5044 2862 5078 4740 5079 5080 5077 5126 5081 4739 5082 4742 5083 2873 5084 5085 4741 2872 2863 5129 5127 5128 2866 5131 2871
	5130 4738 2672 3473 4868 2677 2675 4812 2679 2738 4810 2774 3858 2773 2790 3830 2789 3831 3829 2787 2788 2812 5090 3837 5089 3832
	3833 2803 5088 5086 3838 2804 2818 5087 3698 5321 2954 2784 3844 2783 4953 3845 3847 3848 2768 2785 3836 2786 3835 3834 2769 4944
	2767 4945 3839 3869 4958 3868 4946 3867 4957 4955 2766 4956 3866 4954 4962 4963 2763 3871 3870 2815 4969 4970 4757 4971 2762 3865
	2770 3864 3863 3861 2749 3860 2771 3862 2727 2750 2742 2715 2747 2761 4771 4772 2744 4767 4770 2743 4769 2741 4768 4764 2712 4766
	2740 4765 4777 2731 4776 4947 3840 3841 4948 3842 2780 5219 5214 5235 2888 5215 5234 5233 5232 5213 5231 5212 5211 5210 2885 5209
	5208 2884 5196 5198 5199 2882 5206 5207 5200 5201 2881 5205 2887 5202 5204 5203 2851 2847 5181 2838 5052 5182 2837 5051 2842 5050
	4750 5056 2848 5058 5057 5183 4748 4749 5184 2836 5033 5030 5032 2835 5031 5047 4745 5046 5048 4744 5042 5045 4743 2868 5072 5073
	5169 5168 2852 2874 5064 5071 5065 2875 5070 5062 2878 5063 2877 5066 5069 2876 5068 5067 5060 2880 5061 2879 5059 5171 2870 5170
	5172 2867 5260 5261 5268 5267 2889 5269 5271 5270 5259 5262 5263 5264 5266 5265 2897 5302 5303 5301 2898 5300 5299 2900 5175 2899
	5173 5179 5180 5178 5176 5174 2886 5177
	#New Europe
	11 9 5566 5565 5568 5 2 5567 6 5569 5570 7 3245 5560
	#Africa
	705 707 602 587 600 603 611 601 624 626 622 614 610 609 610 604 599 605 598 589 583 580 576 570 569 563 560 558 555 553 552 520 521
	522 526 527 528 529 544 531 541 540 561 564 571 574 581 586 902 903
}

normal_winter = {
	2906 1834 1830 1832 1839 1840 1835 1833 1831 1837 1836 1838 1842 1844 1870 1878 1862 1847 1858 1863 1882
	1879 1846 1848 1881 1884 1873 1874 1875 1871 1869 1877 1872 1868 1876 1880 1892 1893 1888 1889 1891 
	1887 1886 1890 1883 1885 1910 1909 1903 1865 1864 1866 1855 1861 1904 1902 1905 1908 1894 1895 1896 1897 1920 
	1900 1901 1899 2030 2031 2023 2026 1970 2028 2027 2024 1898 2025 1969 1911 1973 1975 1979 1980 2029
	1971 2040 2043 2042 2036 2041 2046 2047 2048 2049 2053 2054 2052 2057 2051 2062 2061 2060 2055 2063
	1786 1785 1789 1790 1791 1768 1766 1775 1778 1796 1752 1749 1751 1763 1765 1780 1776 1777 1779 1867
	1802 1804 1805 1797 1803 1851 1852 1853 1854 1860 1850 1849 1859 1856 1857 1808 1801 1807 1845 1843
	1800 1798 1799 1806 1841 1760 1758 1759 1764 1761 1784 1792 1783 1787 1793
	1788 1795 1762 1767 1794 510 492 512 513 511 507 509 506 505 475 508 503 504 477 1770 1769 1771 1774
	495 496 514 498 497 499 488 500 501 502 485 487 481 480 479 476 467 466 402 383 464 461 462 463 465
	428 429 434 432 424 426 427 430 422 423 397 403 425 400 392 393 391 395 394 416 410 409 411 412 271 
	324 322 326 323 325 319 321 320 311 318 309 310 312 301 313 316 317 314 315 328 329 330 332 327 
	334 333 335 336 337 331 339 338 342 343 346 347 344 345 340 341 348 349 362 363 364 361 359 357 360 
	307 308 305 306 302 285 293 298 300 299 288 295 296 297 294 365 95 96 99 110 105 106 113 117 119 2064
	1198 1200 1201 1175 1176 1244 1243 1177 1235 1174 1229 1230 1234 1241 1242 1245 1236 1238 1239 1240 1237 1232 1233
	1914 1915 1912 1913 1246 1247 1248 1178 1180 1182 1179 1181 1185 1187 1172 1173 1169 1168 1159 1160 1153 1154 1151 
	1184 1186 1145 1143 1194 1138 1195 1196 1193 1141 1188 1183 1190 1191 1192 1123 1127 1128 1129 1134 1135 1132 1133 
	1131 1126 1125 1121 1119 1189 1110 1120 1118 1124 1116 1115 1122 1109 1108 1916 1918 1923 1917 1936 1931 1933 1935 
	1939 1942 1944 1050 1049 1056 1055 1053 81 77 63 55 49 50 47 44 247 252 256 249 244 243 240 262 217 213 218 208 261
	202 205 206 260 219 220 237 224 225 264 263 232 234 235 236 238 132 131 2073 2074 2433 2434 2432 2437 2435 2436 2438 
	2429 2428 2233 2234 2235 2242 2245 2380 2381 2341 2378 2385 2388 2393 2392 2391 2390 2394 2395 2396 2397 2692 2343 
	2342 2340 2142 2330 2244 2246 2238 2221 2193 2185 2191 2187 2186 2184 2224 2226 2216 2215 2217 2208 2203 2202 
	2200 2199 2693 2694 2696 2494 2691 2698 2690 2688 2689 2687 2495 2686 2736 2684 2678 2673 2661 2444 2446 2447 2448
	2453 2450 2457 2454 2458 2460 2462 2461 2463 2459 2406 2407 2404 2405 2464 2467 2089 2402 2699 2700 2702 2703 2719 
	2720 2758 1757 2723 2759 2893 2894 2891 2218 2222 2243 2220 2237 2236 2232 2231 2230 2181 2141 2140 2138 2139
	2021 2022 1963 2015 2014 1947 1946 1940 1937 1925 1934 1932 1922 1926 1949 1952 1924 1965 1955 1954 1953 1956 1214 
	1213 1218 1219 1220 1208 1206 1210 1216 1217 1204 1205 1207 1209 1211 1223 1225 1226 1227 471 469 1772 1773
	385 474 473 472 384 377 380 381 382 376 401 421 404 405 460 1756 1755 1782 1811 1812 1829 1821 1822 1820 1825 
	1197 1059 1058 1057 1130 1073 1075 1064 1060 1051 1010 1137 1048 1042 1038 1034 1028 1052 1054 1020 1019 1008 2307 2304 2389
	2860 2859 2825 2807 2800 2819 2821 2849 3017 1161 1162 1982 2059 2058 270 2305 2931 2823 2932 2850 3247 
	3248 3249 3250 3251 3343 3344 3333 3334 3340 3336 3337 3338 3359 3361 3374 3369 3363 3368 3370 3371 3373 3317 3315 
	3329 3302 3305 3308 3380 3381 3389 3393 3394 3395 3396 3399 3400 3238 3239 3240 3241 3242 
	4138 4139 4140 4141 4142 4143 4146 4153 4156 4158 4159 4160 4155 4157 4161 4165 4167 4187 4154 4162 4166 4184 4185 4186 4163
	4145 4147 4148 4149 4150 4151 4152 4133	4134 4135 4136 4137 4144 4057 4058 4059 4060 4061 4062 4063 4052 4053 4054 4055 4056
	4045 4046 4047 4048 4050 4051 4049 4038 4039 4040 4041 4042 4043 4044 4024 4025 4026 4027 4028 4029 4017 4018 4019 4020 4021 4022 4023 
	4012 4013 4014 4015 4016 4006 4007 4008 4009 4010 4011 4000 4001 4002 4004 4005 4030 4031 4032 4033 4034 4035 4036 4037
	4089 4090 4091 4092 4093 4095 4096 4097 4098 4198 4199 4200 4201 4203 4213 4214 4194 4196 4197 4207 4209 4211 
	4094 4109 4117 4118 4119 4104 4105 4106 4120 4272 4260 4271 4309 4357 4359 4360 4123 4125 4126 4127 4130 4131 
	4122 4124 4128 4129 4132 4113 4116 4121 4358 4099 4110 4111 4112 4114 4115 4079 4080 4081 4082 4083 4085 4087
	4067 4084 4086 4088 4064 4065 4066 4068 4069 4070 4071 4072 4073 4074 4075 4076 4077 4078 4168 4169 4170 4171 4173 4179 4188
	4172 4174 4180 4181 4182 4567 4568 4175 4183 4217 4219 4220 4225 4176 4177 4178 4190 4191 4192 4204 4208 4221 4222 4223 4224 4226 4227
	4242 4243 4244 4247 4248 4374 4380 4381 4382 4385 4388 4396 4363 4366 4367 4371 4372 4373 4375 4376 4343 4323 4344 4345 4356 4361
	4274 4291 4293 4294 4295 4301 4316 4308 4189 4193 4195 4202 4205 4210 4216 4346 4347 4348 4364 4365 4370 4212 4206 4215 4369 4379 
	4411 4457 4458 4459 4467 4300 4307 4311 4313 4318 4320 4321 4310 4312 4319 4322 4324 4333 4383 4387 4390 4391 4394 4395 4399 4401
	4368 4386 4389 4392 4393 4397 4398 4240 4245 4246 4249 4250 4251 4570 4164 4349 4350 4351 4352 4353 4354 4355 4362 4378
	4101 4102 4100 4103 4269 4261 4340 4325 4326 4330 4342 4336 4339 4228 4229 4241 4238 4230 4233 4234 4231 4236 4547 4543 4481
	4462 4456 4472 4544 4546 4545 4559 4560 4563 4565 4556 4557 4558 4562 4485 4501 4488 4582 4581 4600 4601 4585 4602 4583 4584
	4605 4607 3416 3438 3432 3433 3434 3421 3419 3418 3420 3422 3437 3564 3565 4763 2935 2940
	4722 4721 4779 4780 4782 4783 4784 4785 4786 4787 4788 4792 4793 4794 4795 4797 4799 4800 4813 4816 4817 3475 3474 4867
	4907 4909 4910 4914 4915 4916 4917 4918 4919 4924 4894 4926 4927 4928 4929 4931 4932 4938 5824
	4950 4951 4985 4989 4990 4996 5195 5240 5241 5242 5243 5244 5245 5246 5250 5251 5328 5330 5340
	5341 5342 5344 5345 5520 5521 5533 5712 5713 5717 5718 5750 5753 5757 5758 5759 5760 5763 5764 5765 5766 5767 5768 5769 5770 5771 5772
	5773 5774 5775 5776 5779 5786 5787 5788 5789 5790 5791 5792 5793 5794 5795 5796 5797 5798 5799 5808 5809 5810 5811 5812 5813 5819 5820 5821
	5830 5831 5832 5833 5834 5835 5846 5847 5848 5849 5850 5851 5852 5853 5854 5855 5856 5857 5858 5859 5860 5861 5862
	2858 4720 4991 4992 4993 5013 5014 5015 5016 5017 5018 3253
	2824 2827 4725 4726 4727 4730 4984 4986 4994 4995 4997 4998 4999 5000 5001 5002 5003
	6181 6182 6183 6184 6185 6186 6187 6188 6189 6190 6191 6192 6193 6194 6195 6196
	6111 6112 6113 6114 6115 6116 6117 6118 6119 6120 6121 6134 6135 6136 6137 6138 6139 6140 6141 6142 6143 6147 6148
	6149 6150 6151 6152 6153 6154 6155 6156 6157 6158 6160 6162 6163 6164 6165 6166 6167 6168 6169 6170 6171
	2492 2654 2660 2662 4849 4851 5624 5625 5626 5628 5632 2493 2799 2797 2796
	550 551 545 543 542 536 6202 6203 6204 6205 6206 6210 6211 6214 6217 6218 6219 6220 6223 6224 6225 6226 6227
	6228 6229 6235 6236 6237 6238
	#Korea
	4638 3997 4635 4637 4636 4642 3998 4643 4644 4639 4640 3999 4641 3996 3994 4646 4645 4647 4649 4648 4650 4003 1716 1717 1718 1681
	1683 1725 1723 1726 1724 1720 1682 1721 1722 1730 1740 1727 1739 1728 3995 4651 1706 4653 4652
	3074 5879 1741 1686 5878 5883 5888 1696 5891 1708 5889 5890 1688 1707 1685
	1703 1704 1705 1700 5987 5986 5982 5985 5983 1701 1689 1699 5984 5919 5920 5921 5922 5923 1698 5892 1697 5893 1690 5897 5894 5895
	5896 5898 5899 5901 5900 5902 5903 5909 5910 1693 5911 1691 5912 1692 1694 5913 1695 5906 5907 5904 5905 5908 5914 5915 5916 5917
	5918 5925 5926 5928 5924 5927 5939 1702 5936 5938 5937 5935 5934 5930 5929 5933 5931 5932 5948 5951 5952 5949 5950 5998 1713 6000
	6001 5999 6056 6057 6058 6059 6060 6066 6067 6068 6069 6070 6071 6072 6073 6074 6075 6076 6077 6078 6079
	6080 6081 6082 6083 6084 6085 6086 6087 6088 6089 6090 6092 6093 6096 6097 6098 6099 6101 6102 6103 6104 6105
	6106 6107 6108 6109 6110
} 

severe_winter = {
	1823 1824 1826 1907 1906 1966 1967 1968 1962 1960 1959 1958 1957 1961 1948 1941 1950 1951 
	373 370 374 378 379 100 111 112 470 468 115 1212 1215 1199 1202 1221 1203 1222 1228 1231
	2426 2427 2425 2424 2422 2423 2386 2382 2421 2414 2409 2456 2408 2398 2412 2413 2420 2416
	2411 2410 2400 2697 2695 2401 2080 2075 2439 2440 2441 2443 2445 2451 2452 2455 2469 2085 
	2084 2083 2082 2081 2896 2895 265 272 375 273 274 275 276 1224 1930 1929 1928 1927 2239 
	2240 2241 2379 2383 2419 2418 2417 2399 2088 2087 2086 2756 2855 2844 2843 2950 2415 2449
	1827 1828 1921 2032 2112 2113 2999 2995 2990 2987 2988 2971 2962 2808 2809 2431 2442 5346 5347 546
	2820 2822 3246 3254 3354 3355 3356 3357 3358 3352 3348 3349 3350 3347 3335 3351 3332 3339 3341
	3312 3311 3331 3342 3360 3362 3364 3365 3366 3367 3378 3377 3379 3412 3225 3402 3401 3403 3404 
	3407 3408 3405 3414 3409 3217 4237 4218 4232 4239 4235 4552 4606 4549 4553 4551 4550 4554 4555 
	4604 3429 3417 3540 3537 3012 3896 3899 3889 3888 3890 3887 3936 3937 3938 3939 3940
	4654 4655 4656 4657 4658 4659 4660 4661 4662 4663 4664 4665 4666 4667 4668 4669 4670 4671 4672 4673 4674
	4675 4676 4677 4678 4679 4680 4681 4682 4683 4684 4685 4686 2757
	4687 4688 4689 4690 4691 4692 4693 4694 4695 4696 4697 4698 4699 4700 4701 4702 4703 4704 4705 4706 4707
	4708 4709 4710 4711 4712 4713 4714 4715 4716 4717 4718 4719 5343
	4796 4798 4860 4861 4862 4863 4864 4865 2430 6207
	4908 4911 4912 4913 4920 4921 4922 4923 4925 4937 5247 5248 5249 5252 5253 5254
	5304 5305 5306 5307 5308 5309 5310 5311 5312 5313 5314 5315 5316 5317 5318 5319 5320 5329
	6177 6178 6179 6180 6197 6198 6199 6200 6201 2974 5339 6208 6209
	6122 6123 6124 6125 6126 6127 6128 6129 6130 6131 6132 6133 6144 6145 6159 6161 6172 6173 6174 6175 6176
	6212 6213 6215 6216 6221 6222 6230 6231 6232 6233 6234
	#Korea
	1684 1687 1709 1710 1719 1729 1736 1737 1738 4377 4616 5880 5881 5882 5884 5885 5886 5887 6061 6062 6063
	6064 6065 6091 6094 6095 6100
}

impassable = {
	257 258 259 260 261 262 263 264 265 266 267 268 269 270 271 272 273 274 275 276 375 520 546
	667 668 669 670 671 672 673 684 687 688 714 771 797 798 799 800 850 851 852 853 854 899 900
	902 903 907 908 926 927 928 1008 1009 1010 1051 1057 1058 1059 1130 1161 1162 1197 1224 1827
	1828 1921 1927 1928 1929 1930 2032 2086 2087 2088 2112 2113 2138 2139 2140 2141 2142 2181
	2241 2240 2239 2247 2248 2250 2305 2315 2327 2330 2355 2365 2379 2383 2390 2399 2417 2418
	2419 2494 2495 2496 2527 2590 2591 2631 2752 2753 2754 2755 2756 2757 2758 2759 2760 2774
	2796 2797 2798 2799 2800 2807 2808 2809 2810 2843 2844 2847 2849 2850 2851 2852 2853 2854
	2855 2906 2925 2950 3040 3048 3112 3129 3154 3171 3155 3207 3217 3218 3219 3220 3221 3222
	3223 3225 3226 3233
	3234 3235 3236 3238 3239 3240 3241 3242 3243 3244 3245 3246 3247 3248 
	3249 3250 3251 3252 3253 3254 3255 4714 4860 4861 4862 4863 4864 4865 5824 5834 5835
	# Water Wasteland
	1593 1595 1596 1599 1600 1602 1608 1609 1610 1613 1625 1628 1630 1631 1632 1633 1634 1635 
	1636 1637 1638 1919 1651 1652 1653 1654 1655 1656
	#China Added
	4581 4582 4583 4584	4585 4586 4587 4600 4601 4602 4603 4604	4605 4606 4607  
	
	3401 3402 3403 3404 3405 3406 3407 3408 3409  3410 3411 3412 3413 3414 3415
	3479 3480 3481 5314 5320 5500
}

mild_monsoon = {
	3193 3194 3198 3199 3200 3202 3163 3162 3166 3168 3153 3132 3151 3148 3140 3141 3143 3139 3136 3149 3138 3191 3135 3134 3133 3122 3124 3123 3126 3125 3127 3128
	3114 3113 3109 3119 3190 3120 3053 3121 3137 3185 3118 924 919 920 3156 3157 3147 3145 3142 3174 3131 2917 2918 2915 2948 2916 2957 3098 3095 3096 3092 3081 3082
	3080 2967 2963 2947 2946 2951 2940 3278 3271 3270 3490 3484 3482 3527 3528 3529 3530 3535 3565 3580 3597 3598 3599 3629 3659 3660 3661 3662 3663 3664 3667
	3668 3670 3671 3672 3673 3674 3675 3676 3880 3876 3879 3878 3877 3759 3748 3751 3809 3813 3758 3810 3811 3812 3756 3821 3795 3819 3794 3798 3797 3669 3130 3152
	3150 3820 3823 3796 3822 3807 3808 3804 3805 3806 3799 3800 2953 2914 3533 3526 2956 3532 2959 2965 2966 3554 2964 3628 3093 3602 3094 3600 3761 3553 2960 3557
	3556 4832 4831 3555 3559 2938 2945 3558 3567 2936 3488 3483 3566 3560 2934 2933 2930 3563 2943 3562 3561 3487 2942 3552 2941 3485 3551 3550 2944 2927 2941 3549
	4842 3946 3947 3948 3949 3950 3952 3954 3955 4819 4820 4821 4822 4823 4824 4825 4826 4827 4828 4829 4830 4833 4834 4835 4836 4837 4838 4839 4840 4841 4843 5097
	5098 5099 5100 5106 5107 2913 3509 3511 3489 3510 2912 2794 3508 2793 3283 3285 3284 3286 3287 683 681 918 917 916 912 911 914 913 910 915 905 904 862 865 866
	867 870 874 880 883 897 3290 3289 898 895 2600 2619 2627 2613 2599 2617 2598 2597 2595 2618 2616 2596 2594 2615 2614 2611 2610 2593 2624 2592 2571 2566 2640
	2639 2647 2644 2641 2645 878 882 881 877 876 879 875 873 871 896 872 3276 3275 3268 909 859 5143 5144 5145 5146 5147 5148 5151 5152 5153 5154 5155 5156 5157 5326
	5327 5337 5338 5341 5342 5366 5367 5368 5369 5371 5437 5438 5439 5440 5441 5442 5443 5444 5445 5446 5447 5448 5449 5450 5451 5481 5482 5483
}

normal_monsoon = {
	3205 3204 3206 3203 3167 3164 3182 3111 3184 3102 2920 3100 3089 3103 2958 2921 3097 3090 3091 3101 3084 3086 3085 3083 3189 3104 3106 3105 3059 3069 3107 3187
	3186 3058 3115 3117 3116 3057 3056 3052 3050 3051 3047 3049 3046 3044 3045 3034 3035 3036 3037 3026 3024 3023 3020 3029 3027 3025 3028 3041 3042 2985 2982 2984 
	3006 3007 3019 3018 3021 3022 3033 2997 2996 3000 2998 2993 2991 2989 2986 2994 2992 2979 2976 2978 2981 2983 3030 3031 3032 3038 3039 3071 3072 3077 3078 3073
	3075 3043 3188 2977 2980 2975 2973 2970 2961 2969 2937 2939 2968 3079 3110 3108 3165 922 921 923 2972 3017 5370 5372 5373 5374 5375 3281 3282 3280 3277 3274 3269
	3491 3492 3502 3497 3501 3494 3498 3534 3536 3568 3569 3570 3571 3579 3581 3582 3583 3585 3586 3587 3588 3589 3590 3591 3592 3593 3594 3595 3596 3601 3603 3604
	3605 3606 3607 3608 3609 3610 3611 3612 3613 3614 3615 3616 3617 3618 3619 3620 3621 3622 3623 3624 3625 3626 3627 3651 3630 3631 3632 3633 3634 3635 3636 3637
	3638 3639 3640 3641 3642 3643 3644 3645 3646 3647 3648 3649 3650 3653 3654 3655 3656 3657 3658 3677 3678 3679 5361 5376 5377 5378 5379 5380 5381 3745 3746 3744
	3750 3749 3755 3754 3757 3752 3743 3753 3742 3881 3707 3706 3703 3705 3704 3786 3787 3788 3785 3815 3814 3817 3818 3816 3733 3724 3725 3732 3731 3726 3729 3728
	3727 3730 3773 3769 3771 3775 3781 3774 3780 3782 3783 3778 3779 3777 3828 3826 3827 3824 3825 3709 3907 3908 3909 3906 3710 3712 3711 3910 3708 3715 3891 3892
	3893 3882 3895 3894 3883 3885 3884 3767 3765 3716 3766 3768 3714 3717 3713 3763 3760 3762 3886 3776 3734 3736 3789 3784 3764 3911 3912 3913 3914 3915 3916 3917
	3918 3919 3920 3921 3922 3923 3924 3925 3926 3927 3928 3929 3930 3931 3932 3935 3941 3942 3943 3944 3945 3951 3953 3959 3960 5339 5340 5343 5344 5348 5349 5350
	5351 5352 5353 5385 5386 5387 5388 5389 5390 5391 5392 3966 3967 3968 3969 3970 3971 3972 3974 3975 3979 3980 5357 5359 5360 5362 5363 5364 5365 3201 3196 3197
	3195 3063 3192 3144 3159 3161 3160 3801 3146 3803 5415 5091 5092 5093 5094 5095 5096 5101 5102 5103 5104 5105 3158 5108 5109 5110 5111 5112 5113 5114 5115 5116
	5117 5118 5119 5120 3295 3296 3297 3299 3298 901 863 864 869 868 5138 5139 5140 5141 5142 5158 5159 5160 5161 5162 5163 5164 5165 5166 5167 5332 5332 5333 5334
	5335 5336 5394 5395 5396 5397 5398 5399 5400 5401 5402 5403 5404 5405 5406 5407 5408 5409 5410 5416 5417 5418 5419 5420 5421 5422 5424 5331 5426 5429 5430 5433
	5434 5435 5436 5452 5453 5454 5455 5456 5457 5458 5459 5460 5461 5462 5463 5464 5465 5466 5467 5468 5469 5470 5471 5473 5478 5479 5480
	5484 5485 5486 5487 5488 5489 5490 5491 5492 5493 5494 5495
	#vietnam
	1657 1658 1659 1660 1661 1662 1663 1664 1665 1666 1667 1668 1669 1670 1671 1672 1673 1674 1675 1676 1677 1678 1679 1680
}

severe_monsoon = {
	3183 3181 3180 3179 3178 3177 3176 3175 3173 3172 3170 3169 3099 2919 3087 3076 3067 3065 3066 3064 3067 3062 3061 3055 3060 3070 3068 3054 3008 3010 3004 3011
	3012 3013 3014 3016 3003 3002 3005 2999 2995 2990 2987 2988 2974 2971 2962 3009 3001 3493 3495 3496 3503 3504 3505 3506 3507 3500 3520 3521 3522 3523 3524 3499
	3537 3538 3539 3540 3541 3542 3543 3544 3545 3546 3547 3573 3574 3575 3576 3577 3578 3584 3652 3665 3666 3680 3681 3682 3683 3684 3685 3686 3687 3747 3737 3739
	3740 3741 3735 3738 3791 3790 3793 3792 3723 3722 3719 3718 3719 3721 3722 3905 3902 3901 3903 3904 3770 3772 3900 3898 3899 3896 3897 3015 3887 3890 3888 3889
	3936 3937 3938 3939 3940 3956 3957 3958 3961 3962 3963 3964 3965 3973 3976 3977 3978 5121 5122 5123 5124 5125 5346 5347 5356 5358 5354 5355 5382 5383 5384 5393
	5411 5412 5413 5414 5423 5425 5427 5428 5431 5432 5472 5474 5475 5476 5477
}

tropical = {
	921 922 923
	3184 3183 3182 3181 3180 3179 3178 3177 3176 3175 3173 3172 3170 3169 3168 3167 3166 3165 3164 3162 3163 3161 3159 3063 3144 3192 3142 3141 3143 3145 3139 3140 3138 3136 3135 3191 3121 3190 3120 3185 3118 3058 3117 3186 3059 3057 3060 3054 3056 3053 3507 3052 3061 3055 3051 3050 3049 3046 3047 3062 3045 3044 3065 3064 3066 3038 3037 3506 3034 3035 3036 3032 3033 3031 3022 3019 3021 3018 3009 3008 3010 3193 3194 3198 3205 3206 3204 3203 3197 3137 3494 3498 3501 3497 3502 3503 3496 3495 3505 3504 3822 3723 3493 3573 3574 3575 3576 3610 3651 3652 3653 3654 3655 3656 3657 3658 3659 3665 3666 3684 3685 3686 3687 3674 3675 3677 3678 3679 3682 3683 3961 3962 3963 3964 3965 3721 3792 3793 3786 3788 3785 3733 3725 3724 3732 3731 3726 3728 3727 3729 3730 3722 3744 3719 3718 3720 3791 3790 3789 3681 3747 3745 3746 3750 3794 3798 3816 3607 3815 3609 3030 3784 3787 3039 3619 3071 3734 3736 3735 3738 3972 3075 3977 3978 3740 3592 3089 3927 3960 3578 3958 3577 2919 3195 3196 3199 3201 3200 3202 3160 3158 3801 3146 3802 3803 3676 3808 3147 3795 3819 3821 3123 3124 3813 3122 3660 3751 3748 3797 3149 3796 3125 3809 3810 3119 3126 3664 3174 3662 3131 3800 3153 3806 3670 3132 3116 3749 3581 3582 3115 3109 3755 3113 3757 3108 3187 3754 3107 3583 3918 3111 3916 3110 3917 3919 3594 2920 3920 3102 3921 3922 3579 3593 3752 3106 3743 3967 3968 3966 3069 3975 3974 3680 3067 3737 3973 3070 3753 3587 3189 3742 3969 3970 3741 3105 3104 3980 3979 3739 3068 3923 3585 3924 3586 3925 3928 3103 3929 3590 3930 3088 3934 3933 3588 3100 3926 3589 3957 5091 5092 5093 5094 5095 5096 5097 5098 5099 5101 5102 5103 5104 5105 5106 5107 5108 5109 5110 5111 5112 5113 5114 5115 5121 5122 5123 5124 5125 5375 5392 5393 5402 5403 5404 5406 5408 5409 5410 5411 5412 5413 5415 5416 5417 5418 5419 5420 5421 5422 5423 5424 5425 5426 5427 5428 5429 5430 5431 5432 5433 5434 5435 5436 5437 5438 5439 5440 5441 5442 5443 5479
	5444 5445 5446 5447 5448 5449 5450 5451 5452 5453 5454 5455 5456 5457 5458 5459 5460 5461 5462 5463 5464 5465 5466 5467 5468 5469 5470 5471 5472 5473 5474 5475
	5476 5477 5478 5480
	#vietnam
	1657 1658 1659 1660 1661 1662 1663 1664 1665 1666 1667 1668 1669 1670 1671 1672 1673 1674 1675 1676 1677 1678 1679 1680
}
equator_y_on_province_image = 898