width = 6400
height = 2560


max_provinces = 8401

sea_starts = {
	1251 1252 1253 1254 1255 1256 1257 1258 1259 1260 1261 1262 1263 1264 1265 1266 1267 1268 1269 1270 1271 1272 1273 1274 1275 1276 1277 1278 1279
	1280 1281 1282 1283 1284 1285 1286 1287 1288 1289 1290 1291 1292 1293 1294 1295 1296 1297 1298 1299 1300 1301 1302 1303 1304 1305 1306 1307 1308
	1309 1310 1311 1312 1313 1314 1315 1316 1317 1318 1319 1320 1321 1322 1323 1324 1325 1326 1327 1328 1329 1330 1331 1332 1333 1334 1335 1336 1337 
	1338 1339 1340 1341 1342 1343 1344 1345 1346 1347 1348 1349 1350 1351 1352 1353 1354 1355 1356 1357 1358 1359 1360 1361 1362 1363 1364 1365 1366 
	1367 1368 1369 1370 1371 1372 1373 1374 1375 1376 1377 1378 1379 1380 1381 1382 1383 1384 1385 1386 1387 1388 1389 1390 1391 1392 1393 1394 1395 
	1396 1397 1398 1399 1400 1401 1402 1403 1404 1405 1406 1407 1408 1409 1411 1412 1413 1414 1415 1416 1417 1418 1419 1420 1421 1422 1423 1424 
	1425 1426 1427 1428 1429 1430 1431 1432 1433 1434 1435 1436 1437 1438 1439 1440 1441 1442 1443 1444 1445 1446 1447 1448 1449 1450 1451 1452 1453 
	1454 1455 1456 1457 1458 1459 1460 1461 1462 1463 1464 1465 1466 1467 1468 1469 1470 1471 1472 1473 1474 1475 1476 1477 1478 1479 1480 1481 1482 
	1483 1484 1485 1486 1487 1488 1489 1490 1491 1492 1493 1494 1495 1496 1497 1498 1499 1500 1501 1502 1503 1504 1505 1506 1507 1508 1509 1510 1511 
	1512 1513 1514 1515 1516 1517 1518 1519 1520 1521 1522 1523 1524 1525 1526 1527 1528 1529 1530 1531 1532 1533 1534 1535 1536 1537 1538 1539 1540 
	1541 1542 1543 1544 1545 1546 1547 1548 1549 1550 1646 7431
	#China Sea
	4609 4610 4611 4612 4613 4614 4615 4617 4618 4619 4620 4621 4622 4623 4624 4625 3222 3226 8281 8282 8283 8284 8285 8286 8287 8288 8289 8290 8291
	8292 8293 8294 8295 8296 8297 8298 8299 8300 8301 8302 8303 8304 8305 8306 8307 8308 8309 8310 8311 8312 8313 8314 8315 8316 8317 8318 8319 8320
	
	#Joseon Sea
	1714 1715 3301 3397 3428 3993 5498 5499 8351
	#Japan Sea
	7500 7501 7502 7503 7504 7505 7506 7507 8349 8350 8352 8353
	#Filipinas
	6597 6598 6599 6600 6601 6602 6603 6604 6605 6606 6607 6608 7876 7877 7878 7879 7880 7881 7882 7883
	7884 7885 7886 7887 7888 7889 7890 7891 7892 7893 7894 7895 7896 7897 7898 7899 7900 7072 7073 7074 7075 7076 7077
	7078 7079 7080 7081 7082 7083 7084 7085 7086 7943 7944
	#Mesopotamia
	3478 4593 4579 5496 5497 
	#South East Asia
	6836 6837 6838 6839 6840 6841 6842 6843 6844 6845 6846 6847 6848 6849 6850 1654 6851
	6852 6853 6854 6855 6856 6857 6858 6859 6860 6861 7087 7088 7089 7090 7091 7092 7093 7094 7095 7096 7097 7098
	7099 7100 7489 7490 7491 7492 7493 7494 7495 7496 7497 7498 7499 7901 7902 7903 7904 7905 7906 7907 7908 7909 7910
	7911 7912 7913 7914 7915 7916 7917 7918 7919 7920 7921 7922 7923 7924 7925 7926 7927 7928 7929 7930 7931 7932
	7933 7934 7935 7936 7937 7938 7939 7940 7941 7942
	1604 1605 1606 1607 #Nile
	1609 1610 1611 1612 #Danube
	1594 #Elba
	1597 1598 #Rhine
	1601 #Guadalquivir
	1603 #Ebro
	1623 1624 #Indus
	1626 1627 #Ganges
	1629 #Brahmaputra
	1644 #Narmada
	1645 #Mahanadi
	6862 7675 7676 #Mekong
	7677 7678 7679 7680 #Irrawady
	4626 4627 4628 4629 4630 4631 4632 4633 4634 #Huang River
	4588 4589 4590 4591 4592 4594 4595  #Yangtze River
	3271 3272 3273 3278 3279 3280 3281 3285 #Niger River
	1615 #Tanais
	1614 #Borysthenes
}
	
only_used_for_random = {
	#RNW Sea provinces
}

lakes = {
	1551 1552 1553 1554 1555 1556 1557 1558 1559 1560 1561 1562 1563 1564 1565 1566 1567 1568 1569 1570 1571 1572 1573 1574 1575 1576 1577 1578 1579
	1580 1581 1582 1583 1584 1585 1586 1587 1588 1589 1590 1591 1592 1593 1595 1596 1599 1600 1602 1608 1656 8386 8387 8388 8389 8390 8391
	3270 #Inner Niger Delta
	1613 1616 1617 1618 1619 1620 1621 1622 1625 1628 1630 1919  
	1642 1647 1643 1648 1649 1650
	4580 4596  4597  4598  4599  #China added
	3406 3476 3477 3688 3689 3690 3691 3692 3693 3694 3695 3696 3697
	1410
	4844
	6595 6596 6729 #Filipinas
	7694 7695 7975 #SEA
}

force_coastal = {
}

canal_definition = {
	name = "nile_canal"
	x = 1768
	y = 1026
}

definitions = "definition.csv"
provinces = "provinces.bmp"
positions = "positions.txt"
terrain = "terrain.bmp"
rivers = "rivers.bmp"
terrain_definition = "terrain.txt"
heightmap = "heightmap.bmp"
tree_definition = "trees.bmp"
continent = "continent.txt"
adjacencies = "adjacencies.csv"
climate = "climate.txt"
region = "region.txt"
superregion = "superregion.txt"
area = "area.txt"
provincegroup = "provincegroup.txt"
ambient_object = "ambient_object.txt"
seasons = "seasons.txt"
trade_winds = "trade_winds.txt"

# Define which indices in trees.bmp palette which should count as trees for automatic terrain assignment
tree = { 3 4 7 10 }

