north_assyria_to_media_group = {
	4876 2486 4877 4878 2485 4879 2484 2493 2481 4880 3989 2478 2476 3453 2477 3452 3451 2475 2474 3990 2384 4858 4857 4859 2471 2387 3442 4855 4930 4856 2377 3991 4896 2376 2370
	4933 2344  7122 7119 7110 6285 6284 6287 7111 7118 7116 7117 6150 4894 6152 6286 7121 7120 7112 7113 7114
}

arbela_district_group = {
	4876 2486 4877 4878 2485 4879 2484 2481 4880 6287 2493
}

susa_royal_road_group = {
	2158 2159 2179 2194 2197 2216 2219 2222 2336 2337 2338 2345 2370 2371 2471 2472 2476 2478 2482 2483 2489 2499 2500 2652 2657 2658 2663 3439 3441 3450 3454
	3461 3463 4847 4850 4854 4935 5704 5720 5724 5730 5742 5743 5751 5773 5774 6270 6273 6275 6276 6277 7110 7115 7132 7146 7147 7148
}

persepolis_royal_road_group = {
	2665 2666 2670 2672 2673 2678 2682 2683 2684 3473
}

ecbatana_royal_road_group = {
	2653 2654 2655 2688 2690 2691 3457 4786 4792 4851 5626 5627 5628
}

bactra_royal_road_group = {
	2704 2706 2725 2728 2729 2730 2746 2828 2832 2835 2840 4747 4755 4759 4760 4762 4774 4775 4789 4974 4975 4979 5020 5022 5024 5026 5036 5040 5053 5057 5221
	5222
}

athura_province_group = {
	2354 2356 2357 2361 2362 2363 2364 2366 2367 2368 2369 2370 2371 2372 2373 2374 2375 2376 2377 2384 2387 2470 2471 2472 2473
	2474 2475 2476 2477 2478 2479 2480 2481 2482 2483 2484 2485 2486 2487 2491 3227 3228 3439 3440 3441 3442 3449 3450 3451 3452
	3453 3454 3988 3989 3990 3991 4855 4856 4857 4858 4859 4876 4877 4878 4880 4892 4893 4895 4896 4930 6271 6284 6285 6286 6287
	6288 7110 7111 7112 7113 7114 7115 7116 7117 7118 7119 7120 7121 7122 7123 7124 7125 7126 7127 7128 7129 7130 7131 7132 7133
	7134
}

transeuphratia_province_group = {
	2301 2302 2303 2304 2306 2307 2308 2309 2310 2311 2312 2313 2314 2318 2319 2321 2322 2323 2324 2325 2326 2329 2331 2339 2344
	2345 2346 2347 2348 2349 2350 2351 2352 2353 3445 3446 3447 3448 3992 4897 4898 4899 4900 4901 4933 4934 4935 7141 7142 7143
	7144 7145 7146 7147 7148 7149 7150 7151 7152 7153 7154 7155 7156 7157 7158 7159 7160 7161 7162 7163 7162 7163 7164 7165 7166
	7167 7168 7169
}

hellespontine_phrygia_province_group = {
	2115 2116 2117 2118 2119 2120 2143 2144 2145 2146 2147 2148 2149 2150 2151 2152 2153 2154 2161 2179 2180 2185 2186 2187 2188
	2189 2191 5588 5589 5590 5591 5592 5593 5594 5595 5596 5705 5706 5707 5708 5709 5710 5711 5712 5713 5811 5812 5813 5814 5815
	5816 5822 5823 5863 5864 5865 5866 5867 6591
}

indus_province_group = {
	2794 2795 2801 2802 2811 2912 2913 2922 2924 2927 2928 2929 2949 3486 3489 3508 3509 3510 3511 3512 3513 3514 3515 3516 3517
	3518 3519 3548 3701 3702 4836 4839 4840 4841
}

amyrgoi_province_group = {
	2867 2868 2870 2889 2890 2897 2911 5072 5073 5168 5169 5170 5171 5172 5256 5257 5258 5259 5260 5261 5262 5263 5264 5265 5266
	5267 5268 5269 5270 5271 5272 5273 5274 5275 5280 5281 5282 5283 5284 5285 5291 5292 5293 5294 5295 5302
}

ionia_province_group = {
	985 986 987 988 989 990 991 992 993 994 995 996 997 998 2120 2121 2122 2123 2124 2125 2126 2127 2128 2129 5504 5505 5506 5507
	5508 5518 5519 5597 5598 5599 5601 5602 5603 5604 5605 5606 5607 6591
}

phoenicia_province_group = {
	2827 2299 2300 2316 2317 2320 4887 4888 4889 4890 5868 5869 5870 5871 5872 5873 5874 5875 5876 5877
}

dahae_province_group = {
	2721 2836 2837 2838 2840 2841 2842 2848 2881 2882 2883 2884 2885 4748 4749 4750 4751 4752 5049 5050 5051 5052 5054 5055 5056
	5057 5058 5181 5182 5183 5184 5187 5188 5189 5192 5193 5194 5196 5197 5198 5199 5200 5201 5205 5206 5207 5208 5209 5210 5211
	5226 5227 5228 5229 5230
}

ariana_province_group = {
	2725 2726 2762 2763 2764 2765 2815 2830 2839 3865 3870 3871 3872 3873 3874 3875 4756 4757 4758 4959 4960 4961 4962 4963 4964
	4965 4966 4967 4968 4969 4970 4971 4972 4973 5004 5053 5185 5222 5223
}

gedrosia_province_group = {
	2775 2776 2777 2778 2787 2788 2789 2790 2791 2792 2793 2813 2814 3829 3830 3831 3849 3850 3851 3852 3853 3854
}

arachosia_province_group = {
	2783 2784 2785 2803 2804 2806 2812 2816 2817 2818 2819 2820 2821 2831 3832 3833 3836 3837 3838 3844 3845 3846 4949 4950 4951
	4952 4953 5086 5087 5088 5089 5090
}

margiana_province_group = {
	2832 2833 2834 2835 2845 2846 4735 4736 4743 4744 4745 4746 4747 4974 4975 5019 5020 5021 5022 5023 5024 5025 5026 5027 5028
	5029 5030 5031 5032 5033 5034 5035 5036 5037 5038 5039 5040 5041 5042 5043 5044 5045 5046 5047 5048
}

sogdiana_province_group = {
	2861 2862 2863 2864 2865 2866 2869 2871 2872 2873 2891 2892 2893 2894 2895 2896 4737 4738 4739 4740 4741 4742 5074 5075
	5076 5077 5078 5079 5080 5081 5082 5083 5084 5085 5126 5127 5128 5129 5130 5131 5132 5133 5134 5135 5136 5137 5236 5237 5238
	5239 5240 5241 5242 5243 5244 5245 5246 5247 5248 5249 5250 5251 5252 5253 5254 5255 5276
}

bactria_province_group = {
	2824 2825 2826 2827 2828 2829 2856 2857 2858 2859 2860 4720 4721 4722 4723 4724 4725 4726 4727 4728 4729 4730 4731 4732 4733
	4734 4976 4977 4978 4979 4980 4981 4982 4983 4984 4985 4986 4987 4988 4989 4990 4991 4992 4993 4994 4995 4996 4997 4998 4999
	5000 5001 5002 5003 5005 5006 5007 5008 5009 5010 5011 5012 5013 5014 5015 5016 5017 5018
}

chorasmia_province_group = {
	2874 2875 2876 2877 2878 2879 2880 5059 5060 5061 5062 5063 5064 5065 5066 5067 5068 5069 5070 5071
}

gandhara_province_group = {
	2805 2822 2823 2930 2931 2932 2933 2934 2935 2936 2941 2942 2943 2951 2953 2954 3483 3484 3487 3488 3552 3560 3561 3562 2563
	3564 3565 3566 3572 3698 3699 3700 4824 4825 4826 4827 4828 4834 4835 4837 4838 5321 5322 5323 5324 5325 5326 5327 5328 5329
	5330 5338 5345
}

samaria_province_group = {
	2286 2288 2289 2292 2293 2295 2298 4881 4891 5617 5618 5619 5620 5621 5696 5697 5698 5699 7003 7004 7005 7006
}

phrygia_province_group = {
	2155 2156 2157 2158 2159 2170 2177 2178 2190 2192 2194 2195 2198 2199 2200 2210 2211 2212 2214 5600 5601 5703 5704 5714 5715
	5716 5717 5718 5719 5720 5721 5722 5723 5724 5730 5731 5732 5733 5734 5742 5743 5746 5747 5748 5749 5750 5751 5754 5755 5777
	5778
}
