
#mytestgroup = {
#	1 2 3
#}

north_assyria_to_media_group = {
	4876 2486 4877 4878 2485 4879 2484 2493 2481 4880 3989 2478 2476 3453 2477 3452 3451 2475 2474 3990 2384 4858 4857 4859 2471 2387 3442 4855 4930 4856 2377 3991 4896 2376 2370
	4933 2344
}

arbela_district_group = {
	4876 2486 4877 4878 2485 4879 2484 2481 4880
}

susa_royal_road_group = {
	2158 2159 2179 2194 2197 2219 2222 2336 2337 2338 2345 2370 2371 2471 2472 2476 2478 2482 2483 2489 2499 2652 2657 2658 2663 3439 3441 3450 3454 3461
	3463 4847 4850 4854 4935 5704 5720 5724 5730 5742 5743 5751 5773 5774 6270 6273 6275 6276 6277 7110 7115 7132 7146 7147 7148
}

persepolis_royal_road_group = {
	2665 2670 2672 2673 2678 2682 2683 2684 3473
}
