north_assyria_to_media_group = {
	4876 2486 4877 4878 2485 4879 2484 2493 2481 4880 3989 2478 2476 3453 2477 3452 3451 2475 2474 3990 2384 4858 4857 4859 2471 2387 3442 4855 4930 4856 2377 3991 4896 2376 2370
	4933 2344  7122 7119 7110 6285 6284 6287 7111 7118 7116 7117 6150 4894 6152 6286 7121 7120 7112 7113 7114
}

arbela_district_group = {
	4876 2486 4877 4878 2485 4879 2484 2481 4880 6287 2493
}

susa_royal_road_group = {
	2158 2159 2179 2194 2197 2216 2219 2222 2336 2337 2338 2345 2370 2371 2471 2472 2476 2478 2482 2483 2489 2499 2500 2652 2657 2658 2663 3439 3441 3450 3454
	3461 3463 4847 4850 4854 4935 5704 5720 5724 5730 5742 5743 5751 5773 5774 6270 6273 6275 6276 6277 7110 7115 7132 7146 7147 7148
}

persepolis_royal_road_group = {
	2665 2666 2670 2672 2673 2678 2682 2683 2684 3473
}

ecbatana_royal_road_group = {
	2653 2654 2655 2688 2690 2691 3457 4786 4792 4851 5626 5627 5628
}

bactra_royal_road_group = {
	2704 2706 2725 2728 2729 2730 2746 2828 2832 2835 2840 4747 4755 4759 4760 4762 4774 4775 4789 4974 4975 4979 5020 5022 5024 5026 5036 5040 5053 5057 5221
	5222
}
