arbela_district_group = {
	4876 2486 4877 4878 2485 4879 2484 2481 4880 6287 2493
}

susa_royal_road_group = {
	2158 2159 2179 2194 2197 2216 2219 2222 2336 2337 2345 2370 2371 2471 2472 2476 2478 2482 2483 2489 2499 2500 2652 2657 2658
	2663 3439 3441 3450 3454 3461 3463 4847 4850 4854 4935 5518 5610 5704 5720 5724 5730 5742 5743 5751 5773 5774 6270 6273 6275
	6276 6277 7110 7115 7132 7146 7147 7148 8268
}

persepolis_royal_road_group = {
	2665 2666 2670 2672 2673 2678 2682 2683 2684 3473
}

ecbatana_royal_road_group = {
	2653 2654 2655 2688 2690 2691 3457 4786 4792 4851 5626 5627 5628
}

bactra_royal_road_group = {
	2704 2706 2725 2728 2729 2730 2746 2828 2832 2835 2840 4747 4755 4759 4760 4762 4774 4775 4789 4974 4975 4979 5020 5022 5024 5026 5036 5040 5053 5057 5221
	5222
}

###Satrapies

athura_province_group = {
	2354 2356 2357 2361 2362 2363 2364 2366 2367 2368 2369 2370 2371 2372 2373 2374 2375 2376 2377 2384 2387 2470 2471 2472 2473
	2474 2475 2476 2477 2478 2479 2480 2481 2482 2483 2484 2485 2486 2487 2491 3227 3228 3439 3440 3441 3442 3449 3450 3451 3452
	3453 3454 3988 3989 3990 3991 4855 4856 4857 4858 4859 4876 4877 4878 4880 4892 4893 4895 4896 4930 6271 6284 6285 6286 6287
	6288 7110 7111 7112 7113 7114 7115 7116 7117 7118 7119 7120 7121 7122 7123 7124 7125 7126 7127 7128 7129 7130 7131 7132 7133
	7134
}

transeuphratia_province_group = {
	2301 2302 2303 2304 2306 2307 2308 2309 2310 2311 2312 2313 2314 2318 2319 2321 2322 2323 2324 2325 2326 2329 2331 2339 2344
	2345 2346 2347 2348 2349 2350 2351 2352 2353 3445 3446 3447 3448 3992 4897 4898 4899 4900 4901 4933 4934 4935 7141 7142 7143
	7144 7145 7146 7147 7148 7149 7150 7151 7152 7153 7154 7155 7156 7157 7158 7159 7160 7161 7162 7163 7162 7163 7164 7165 7166
	7167 7168 7169
}

hellespontine_phrygia_province_group = {
	2115 2116 2117 2118 2119 2120 2143 2144 2145 2146 2147 2148 2149 2150 2151 2152 2153 2154 2161 2179 2180 2185 2186 2187 2188
	2189 2191 5588 5589 5590 5591 5592 5593 5594 5595 5596 5705 5706 5707 5708 5709 5710 5711 5712 5713 5811 5812 5813 5814 5815
	5816 5822 5823 5863 5864 5865 5866 5867 6591
}

indus_province_group = {
	2794 2795 2801 2802 2811 2912 2913 2922 2924 2927 2928 2929 2949 3486 3489 3508 3509 3510 3511 3512 3513 3514 3515 3516 3517
	3518 3519 3548 3701 3702 4836 4839 4840 4841
}

amyrgoi_province_group = {
	2867 2868 2870 2889 2890 2897 2911 5072 5073 5168 5169 5170 5171 5172 5256 5257 5258 5259 5260 5261 5262 5263 5264 5265 5266
	5267 5268 5269 5270 5271 5272 5273 5274 5275 5280 5281 5282 5283 5284 5285 5291 5292 5293 5294 5295 5302
}

ionia_province_group = {
	985 986 987 988 989 990 991 992 993 994 995 996 997 998 2120 2121 2122 2123 2124 2125 2126 2127 2128 2129 5504 5505 5506 5507
	5508 5518 5519 5597 5598 5599 5601 5602 5603 5604 5605 5606 5607 6591
}

phoenicia_province_group = {
	2827 2299 2300 2316 2317 2320 4887 4888 4889 4890 5868 5869 5870 5871 5872 5873 5874 5875 5876 5877
}

dahae_province_group = {
	2721 2836 2837 2838 2840 2841 2842 2848 2881 2882 2883 2884 2885 4748 4749 4750 4751 4752 5049 5050 5051 5052 5054 5055 5056
	5057 5058 5181 5182 5183 5184 5187 5188 5189 5192 5193 5194 5196 5197 5198 5199 5200 5201 5205 5206 5207 5208 5209 5210 5211
	5226 5227 5228 5229 5230
}

ariana_province_group = {
	2725 2726 2762 2763 2764 2765 2815 2830 2839 3865 3870 3871 3872 3873 3874 3875 4756 4757 4758 4959 4960 4961 4962 4963 4964
	4965 4966 4967 4968 4969 4970 4971 4972 4973 5004 5053 5185 5222 5223
}

gedrosia_province_group = {
	2775 2776 2777 2778 2787 2788 2789 2790 2791 2792 2793 2813 2814 3829 3830 3831 3849 3850 3851 3852 3853 3854
}

drangiana_province_group = {
	2766 2767 2768 2769 2779 2780 2781 2786 3834 3835 3839 3840 3841 3842 3843 3847 3848 3866 3867 3868 3869 4944 4945 4946 4947
	4948 4954 4955 4956 4957 4958 8269 8271 8272 8273
}

arachosia_province_group = {
	2783 2784 2785 2803 2804 2806 2812 2816 2817 2818 2819 2820 2821 2831 3832 3833 3836 3837 3838 3844 3845 3846 4949 4950 4951
	4952 4953 5086 5087 5088 5089 5090 8270 8274
}

margiana_province_group = {
	2832 2833 2834 2835 2845 2846 4735 4736 4743 4744 4745 4746 4747 4974 4975 5019 5020 5021 5022 5023 5024 5025 5026 5027 5028
	5029 5030 5031 5032 5033 5034 5035 5036 5037 5038 5039 5040 5041 5042 5043 5044 5045 5046 5047 5048
}

sogdiana_province_group = {
	2861 2862 2863 2864 2865 2866 2869 2871 2872 2873 2891 2892 2893 2894 2895 2896 4737 4738 4739 4740 4741 4742 5074 5075
	5076 5077 5078 5079 5080 5081 5082 5083 5084 5085 5126 5127 5128 5129 5130 5131 5132 5133 5134 5135 5136 5137 5236 5237 5238
	5239 5240 5241 5242 5243 5244 5245 5246 5247 5248 5249 5250 5251 5252 5253 5254 5255 5276
}

bactria_province_group = {
	2824 2825 2826 2827 2828 2829 2856 2857 2858 2859 2860 4720 4721 4722 4723 4724 4725 4726 4727 4728 4729 4730 4731 4732 4733
	4734 4976 4977 4978 4979 4980 4981 4982 4983 4984 4985 4986 4987 4988 4989 4990 4991 4992 4993 4994 4995 4996 4997 4998 4999
	5000 5001 5002 5003 5005 5006 5007 5008 5009 5010 5011 5012 5013 5014 5015 5016 5017 5018
}

chorasmia_province_group = {
	2874 2875 2876 2877 2878 2879 2880 5059 5060 5061 5062 5063 5064 5065 5066 5067 5068 5069 5070 5071
}

gandhara_province_group = {
	2805 2822 2823 2930 2931 2932 2933 2934 2935 2936 2941 2942 2943 2951 2953 2954 3483 3484 3487 3488 3552 3560 3561 3562 2563
	3564 3565 3566 3572 3698 3699 3700 4824 4825 4826 4827 4828 4834 4835 4837 4838 5321 5322 5323 5324 5325 5326 5327 5328 5329
	5330 5338 5345
}

samaria_province_group = {
	2286 2288 2289 2292 2293 2295 2298 4881 4891 5617 5618 5619 5620 5621 5696 5697 5698 5699 7003 7004 7005 7006
}

phrygia_province_group = {
	2155 2156 2157 2158 2159 2170 2177 2178 2190 2192 2194 2195 2198 2199 2200 2210 2211 2212 2214 5600 5703 5704 5714 5715 5716
	5717 5718 5719 5720 5721 5722 5723 5724 5730 5731 5732 5733 5734 5742 5743 5746 5747 5748 5749 5750 5751 5754 5755 5777 5778
}

caria_province_group = {
	2130 2131 2132 2133 2134 2135 2136 2137 2160 2162 2163 2164 2165 2166 2167 2168 2169 2171 2172 2173 2174 2175 2176 2201 5608
	5609 5700 5701 5702 5725 5726 5727 5728 5729 5735 5736 5737 5738 5739 5740 5741 5744 5745 7171
}

cappadocia_province_group = {
	2182 2183 2184 2193 2196 2197 2213 2216 2218 2219 2220 2221 2222 2223 2224 2225 2226 2227 2228 2229 2230 2231 2232 2233 2234
	2235 2236 2237 2238 2242 2243 2244 2245 2246 2340 2343 2380 2428 4931 5752 5753 5756 5757 5758 5759 5760 5761 5762 5763 5764
	5765 5766 5767 5768 5769 5770 5771 5774 5787 5788 5789 5790 5791 5792 5793 5794 5795 5796 5797 5798 5799 5800 5801 5802 5803
	5804 5805 5806 5807 5808 5809 5810 5817 5818 5819 5820 5821 6177 6178 6181 6182 6183 6184 6202 6203 6204 7559
}

cilicia_province_group = {
	2202 2203 2204 2205 2206 2207 2208 2209 2215 2217 2328 2332 2333 2334 2335 2336 2337 2338 5505 5507 5517 5610 5773 5775 5776
	5779 5780 5781 5782 5783 5784 5785 6591 8268
}

iberia_province_group = {
	2414 2425 2426 2427 2430 2431 2442 2443 2444 2445 2446 2447 2448 2451 2452 2453 4922 6175 6200 6201 6207 6208 6209 6212 6213
	6214 6215 6217 6218 6219 6220 6221
}

armenia_province_group = {
	2341 2342 2378 2381 2382 2385 2386 2388 2389 2391 2392 2393 2395 2408 2409 2410 2411 2412 2413 2416 2420 2421 2422 2423 2424
	3474 3475 4894 4912 4913 4918 4920 4921 4923 4924 4925 4926 4927 4928 4929 4932 4937 4938 5772 5786 6111 6112 6113 6114 6115
	6116 6117 6118 6119 6120 6121 6122 6123 6124 6125 6126 6127 6128 6129 6130 6147 6148 6149 6150 6151 6152 6153 6154 6155 6156
	6157 6158 6159 6160 6161 6162 6163 6164 6165 6166 6167 6168 6169 6170 6171 6172 6173 6174 6176 6179 6180 6185 6186 6187 6188
	6189 6190 6191 6192 6193 6194 6195 6196 6197 6198 6199
}

judea_province_group = {
	2271 2272 2273 2274 2277 2278 2279 2283 2284 2285 3443 3444 4882 4883 4884 4885 4886 5612 5613 5614 5615 5616 5689 5690 5691
	5692
}

nabataea_province_group = {
	2253 2254 2255 2256 2257 2258 2259 2260 2261 2262 2263 2264 2265 2266 2267 2275 2276 2280 2281 2282 2290 2291 2529 2530 2531
	2532 2533 2534 2535 2536 2537 2538 5622 5694 5695 7007
}

thracia_province_group = {
	1086 5587 5586 1085 1087 5836 5585 1084 1081 5584 1082 5583 1080 5582 1079 5828 1089 1083 1113 1114 1088 5837 1091 5829 1112
	5843 1111 1117 5844 5845 1122 1118 1110 5830 1078 5827 1077 5825 1115 1116 1092 1090 5839 1105 1109 5838 1093 5840 1094 1104
	5841 1103 1101 1102 1100 1099 1098 1097 1096 1095 5842 999 5826 1076 5521 5520 1075 1074 5522 5523 1072 1065 5528 5525 1071
	1066 1068 1067 1070 5524 1069 5526 1068 5527
}

# Monsoons, to use in popgrowth. They can't be defined in a trigger (doesn't work), so a province group it is

pg_monsoon_mild_group = {
	3168 3153 3132 3151 3148 3140 3141 3143 3139 3136 3149 3138 3191 3135 3134 3133 3122 3124 3123 3126 3125 3127 3128 3114 3113
	3109 3119 3190 3120 3053 3121 3137 3185 3118 3156 3157 3147 3145 3142 3174 3131 2917 2918 2915 2948 2916 2957 3098 3095 3096
	3092 3081 3082 3080 2967 2963 2947 2946 2951 2940 3490 3484 3482 3527 3528 3529 3530 3535 3565 3580 3597 3598 3599 3629 3659
	3660 3661 3662 3663 3664 3667 3668 3670 3671 3672 3673 3674 3675 3676 3880 3876 3879 3878 3877 3759 3748 3751 3809 3813 3758
	3810 3811 3812 3756 3821 3795 3819 3794 3798 3797 3669 3130 3152 3150 3820 3823 3796 3822 3807 3808 3804 3805 3806 3799 3800
	2953 2914 3533 3526 2956 3532 2959 2965 2966 3554 2964 3628 3093 3602 3094 3600 3761 3553 2960 3557 3556 4832 4831 3555 3559
	2938 2945 3558 3567 2936 3488 3483 3566 3560 2934 2933 2930 3563 2943 3562 3561 3487 2942 3552 2941 3485 3551 3550 2944 2927
	2941 3549 4842 3946 3947 3948 3949 3950 3952 3954 3955 4819 4820 4821 4822 4823 4824 4825 4826 4827 4828 4829 4830 4833 4834
	4835 4836 4837 4838 4839 4840 4841 4843 5097 5098 5099 5100 5106 5107 2913 3509 3511 3489 3510 2912 2794 3508 2793 3283
	3286 3287 681 916 911 910 905 865 866 867 874 880 883 897 3290 3289 898 895 2600 2619 2627 2613 2599 2617 2598 2597 2595 2618
	2616 2596 2594 2615 2614 2611 2610 2593 2624 2592 2571 2566 2640 2639 2647 2644 2641 2645 878 882 881 877 876 879 875 873 871
	896 872 3268 909 859 5143 5144 5145 5146 5147 5148 5151 5152 5153 5154 5155 5156 5157 5326 5327 5337 5338 5341 5342 5366 5367
	5368 5369 5371 5437 5438 5439 5440 5441 5442 5443 5444 5445 5446 5447 5448 5449 5450 5451 5481 5482 5483 6291 3220 6290 6289
	6294 6295 6293 6296
	#Japan
	7511 7512 7513 7514 7515 7516
	#Tamilakam Sangam
	6379 6381 6387 6386 6385 6388 6389 6364 6365 6360 6359 6362 6361 6418 6420 6419 6421 6422 6423 6416 6414 6415 6417 6426 6424
	6425 6413 6412 6411 6410 6403 6404 6402 6400 6401 6399 6397 6398 6406 6405 6407 6408 6409 6338 6339 6340 6335 6334 6336 6337
	6333 6332 6306 6331 6341 6342 6343 6344 6349 6350 6351 6345 6348 6347 6346 6352 6353 6355 6354 6356 6357 6358 6328 6330 6303
	6329 6305 6327 6304 6301 6302 6300 6325 6307 6311 6309 6310 6308 6314 6326 6312 6313 6297 6298 6299 6323 6322 6324 6318 6321
	6319 6320
	#SEA
	6756 6757 6758 6759 6760 6761 6762 6763 6764 6765 6766 6767 6768 6769 6770 6771 6772 6773 6774 6775 6776 6777 6778 6779 6780
	6781 6782 6783 6784 6785 6786 6787 6788 6789 6790 6791 6792 6793 6794 6795 6796 6797 6798 6799 6800 6801 6802 6803 6804 6805
	6806 6807 6808 6809 6810 6811 6812 6813 6814 6815 6816 6817 6818 6819 6820 6821 6822 6823 6824 6825 6826 6827 6828 6829 6830
	6831 6832 6833 6834 6835 7526 7528 7544 7551 7552 7553 7545 7549 7550 7548 7546 7547 7656 7657 7658 7659 7660 7661 7662 7663
	7664 7665 7666 7667 7668 7669 7670 7731 7732 7733 7734 7735 7696 7697 7698 7699 7700 7701 7702 7703 7704 7705 7706 7707 7708
	7709 7710 7711 7712 7713 7714 7715 7716 7717 7718 7719 7720 7721 7722 7723 7724 7725 7726 7727 7728 7729 7730 7736 7737 7738
	7739 7740 7741 7742 7743 7744 7745 7746 7747 7748 7749 7750 7751 7752 7753 7754 7755 7756 7757 7758 7759 7760 7761 7762 7763
	7764 7765 7766 7767 7768 7769 7770 7771 7772 7773 7774 7775 7776 7777 7778 7779 7780 7781 7782 7783 7784 7785 7786 7787 7788
	7789 7790 7791 7792 7793 7794 7795 7796 7797 7798 7799 7800 7801 7802 7803 7804 7805
	#Africa
	6540 6588 6904 884 6583 6584 6903 6901 6902 6900 6905 6906 6909 6908 6582 6907 6580 6578 6579 6575 6934 6933 6931 6936 6576
	6571 6935 7001 6573 6572 6570 6948 6947 6949 835 6955 6531 855 856 6954 6953 6532 6960
	6537 6959 857 6958 6941 6945 6946 6944 6565 6546 6545 6965 6967 6561 6966 6563 6995 6996 6990 6544 6992 6969 6539 6970 6968
	6962 6961 6535 858 6536 6956 6957 6534 847  8093 8094 8119 8120 8121 8122 8123 8144 8068 8069 3269 3267
	3266 8011 8015 8017 8018 8016 8019 8135 8136 8077 8078 8079 8080 8379 8373 8382 8380 8377 8374 8375 8392 8393 8394 8397
	8400 8401 8402 8408 8409 8430 8431 8437 8438 8441 8442 8453 8461 8462 912 8407 8413 8414 8417 8426
	8429

}

pg_monsoon_normal_group = {
	3205 3204 3206 3203 3167 3164 3182 3111 3184 3102 2920 3100 3089 3103 2958 2921 3097 3090 3091 3101 3084 3086 3085 3083 3189
	3104 3106 3105 3059 3069 3107 3187 3186 3058 3115 3117 3116 3057 3056 3052 3050 3051 3047 3049 3046 3044 3045 3034 3035 3036
	3037 3026 3024 3023 3020 3029 3027 3025 3028 3041 3042 2985 2982 2984 3006 3007 3019 3018 3021 3022 3033 2997 2996 3000 2998
	2993 2991 2989 2986 2994 2992 2979 2976 2978 2981 2983 3030 3031 3032 3038 3039 3071 3072 3077 3078 3073 3075 3043 3188 2977
	2980 2975 2973 2970 2961 2969 2937 2939 2968 3079 3110 3108 3165 922 923 2972 3017 5370 5372 5373 5374 5375 3282 3277 3274
	3491 3492 3502 3497 3501 3494 3498 3534 3536 3568 3569 3570 3571 3579 3581 3582 3583 3585 3586 3587 3588 3589 3590 3591 3592
	3593 3594 3595 3596 3601 3603 3604 3605 3606 3607 3608 3609 3610 3611 3612 3613 3614 3615 3616 3617 3618 3619 3620 3621 3622
	3623 3624 3625 3626 3627 3651 3630 3631 3632 3633 3634 3635 3636 3637 3638 3639 3640 3641 3642 3643 3644 3645 3646 3647 3648
	3649 3650 3653 3654 3655 3656 3657 3658 3677 3678 3679 5361 5376 5377 5378 5379 5380 5381 3745 3746 3744 3750 3749 3755 3754
	3757 3752 3743 3753 3742 3881 3707 3706 3703 3705 3704 3786 3787 3788 3785 3815 3814 3817 3818 3816 3733 3724 3725 3732 3731
	3726 3729 3728 3727 3730 3773 3769 3771 3775 3781 3774 3780 3782 3783 3778 3779 3777 3828 3826 3827 3824 3825 3709 3907 3908
	3909 3906 3710 3712 3711 3910 3708 3715 3891 3892 3893 3882 3895 3894 3883 3885 3884 3767 3765 3716 3766 3768 3714 3717 3713
	3763 3760 3762 3886 3776 3734 3736 3789 3784 3764 3911 3912 3913 3914 3915 3916 3917 3918 3919 3920 3921 3922 3923 3924 3925
	3926 3927 3928 3929 3930 3931 3932 3935 3941 3942 3943 3944 3945 3951 3953 3959 3960 5339 5340 5343 5344 5348 5349 5350 5351
	5352 5353 5385 5386 5387 5388 5389 5390 5391 5392 3966 3967 3968 3969 3970 3971 3972 3974 3975 3979 3980 5357 5359 5360 5362
	5363 5364 5365 3201 3196 3197 3195 3063 3192 3144 3159 3161 3160 3801 3146 3803 5415 5091 5092 5093 5094 5095 5096 5101 5102
	5103 5104 5105 3158 5108 5109 5110 5111 5112 5113 5114 5115 5116 5117 5118 5119 5120 3295 3296 3297 3299 3298 901 863 864 869
	868 5138 5139 5140 5141 5142 5158 5159 5160 5161 5162 5163 5164 5165 5166 5167 5332 5332 5333 5334 5335 5336 5394 5395 5396
	5397 5398 5399 5400 5401 5402 5403 5404 5405 5406 5407 5408 5409 5410 5416 5417 5418 5419 5420 5421 5422 5424 5331 5426 5429
	5430 5433 5434 5435 5436 5452 5453 5454 5455 5456 5457 5458 5459 5460 5461 5462 5463 5464 5465 5466 5467 5468 5469 5470 5471
	5473 5478 5479 5480 5484 5485 5486 5487 5488 5489 5490 5491 5492 5493 5494 5495 6292 3934 3088 3933 924 3275 3276
	#Japan
	7508 7509 7510
	#Lanka
	3200 3202 3199 3198 3193 3194 6447 6469 6468 6448 6470 6449 6445 6467 6466 6465 6450 6462 6464 6444 6471 6446 6461 6463 6451
	6460 6440 6443 6459 6458 6457 6438 6439 6442 6456 6455 6454 6453 6441 6452
	#Tamilakam
	6382 6383 6384 6380 6377 6378 3166 6369 6373 6372 6374 6427 6429 6428 6375 6376 6366 3802 6363 6431 6430 6432 6315 6317 6316
	6370 6371 6368 6367 3162 3163
	#SEA
	1657 1658 1659 1660 1661 1662 1663 1664 1665 1666 1667 1668 1669 1670 1671 1672 1673 1674 1675 1676 1677 1678 1679 1680 7560
	7561 7562 7563 7564 7565 7566 7567 7568 7569 7570 7571 7572 7573 7574 7575 7576 7577 7578 7579 7580 7581 7582 7583 7584 7585
	7586 7587 7588 7589 7590 7591 7592 7593 7594 7595 7596 7597 7598 7599 7600 7601 7602 7603 7604 7605 7606 7607 7608 7609 7610
	7611 7612 7613 7614 7615 7616 7617 7618 7619 7620 7621 7622 7623 7624 7625 7626 7627 7628 7629 7630 7631 7632 7633 7634 7635
	7636 7637 7638 7639 7640 7641 7642 7643 7644 7645 7646 7647 7648 7649 7650 7651 7652 7653 7654 7655 7671 7672 7673 7674 7686
	7687 7688 7689 7690 7806 7807 7808 7809 7810 7811 7812 7813 7814 7815 7816 7817 7818 7819 7820 7821 7822 7823 7824 7825 7826
	7827 7828 7829 7830 7980 7981 7982 7983 7984 7985 7986 7987 7988 7989 7990 7991 7992 7993 7994 7995 7996 7997 7998 7999 8000
	3219
	#Africa
	683 913 914 917 918 919 920 6541 6975 6973 6974 6548 6978 6977 6993 904 6994 6547 6987 6976 6979 6549 6982 6542 6988 6991
	6989 6980 6981 6983 6984 6543 6986 915 6985 6914 6913 6550 6912 6910 6919 6551 6552 6911 6918 6920 6554 6997 6921 6917 6915
	6916 6555 6553 6922 6923 6557 6556 6581 6567 6926 6924 6559 6558 6925 6569 6929 6927 6568 6928 6577 870 6932 6930 6939 6937
	6938 6566 6998 6940 6564 6943 6942 6963 6562 6560 6964 862 903 902 8003 8004 8005 8006 8007 8008 8070 8071 8082 8083 8084
	8085 8086 8087 8124 8125 8126 8127 8128 8129 8130 8131 8132 8133 8134 8137 8138 8139 8140 8141 8142 8143 8383 8384 8376 8403
	8404 8405 8406 8410 8411 8412 8415 8416 8420 8421 8422 8423 8424 8425 8427 8428 8450 8451 8452 8456
	8464 8465 8466 8467 8468 8469 8470 8471 8472 8473 8475 8454 8455 8457 8458 8459 8460
}

pg_monsoon_severe_group = {
	3183 3181 3180 3179 3178 3177 3176 3175 3173 3172 3170 3169 3099 2919 3087 3076 3067 3065 3066 3064 3067 3062 3061 3055 3060
	3070 3068 3054 3008 3010 3004 3011 3012 3013 3014 3016 3003 3002 3005 2999 2995 2990 2987 2988 2974 2971 2962 3009 3001 3493
	3495 3496 3503 3504 3505 3506 3507 3500 3520 3521 3522 3523 3524 3499 3537 3538 3539 3540 3541 3542 3543 3544 3545 3546 3547
	3573 3574 3575 3576 3577 3578 3584 3652 3665 3666 3680 3681 3682 3683 3684 3685 3686 3687 3747 3737 3739 3740 3741 3735 3738
	3791 3790 3793 3792 3723 3722 3719 3718 3719 3721 3722 3905 3902 3901 3903 3904 3770 3772 3900 3898 3899 3896 3897 3015 3887
	3890 3888 3889 3936 3937 3938 3939 3940 3956 3957 3958 3961 3962 3963 3964 3965 3973 3976 3977 3978 5121 5122 5123 5124 5125
	5346 5347 5356 5358 5354 5355 5382 5383 5384 5393 5411 5412 5413 5414 5423 5425 5427 5428 5431 5432 5472 5474 5475 5476 5477
	3207
	#Konkana
	6390 6392 6391 6394 6393 6395 6396
	#Vanga
	6517 6518 6516 6519 3720 6515 6520 6521 6522 6523 6524 6527 6525 6526 6529 6528
	#Filipinas
	6609 6610 6611 6612 6613 6614 6615 6616 6617 6618 6619 6620 6621 6622 6623 6624 6625 6626 6627 6628 6629 6630 6631 6632 6633
	6634 6635 6636 6637 6638 6639 6640 6641 6642 6643 6644 6645 6646 6647 6648 6649 6650 6651 6652 6653 6654 6655 6656 6657 6658
	6659 6660 6661 6662 6663 6664 6665 6666 6667 6668 6669 6670 6671 6672 6673 6674 6675 6676 6677 6678 6679 6680 6681 6682 6683
	6684 6685 6686 6687 6688 6689 6690 6691 6692 6693 6694 6695 6696 6697 6698 6699 6700 6701 6702 6703 6704 6705 6706 6707 6708
	6709 6710 6711 6712 6713 6714 6715 6716 6717 6718 6719 6720 6721 6722 6723 6724 6725 6726 6727 6728 6729 6730 6731 6732 6733
	6734 6735 6736 6737 6738 6739 6740 6741 6742 6743 6744 6745 6746 6747 6748 6749 6750 6751 6752 6753 6754 6755
	#SEA
	7831 7832 7833 7834 7835 7836 7837 7838 7839 7840 7841 7842 7843 7844 7845 7846 7847 7848 7849 7850 7851 7852 7853 7854 7855
	7856 7857 7858 7859 7860 7861 7862 7863 7864 7865 7945 7946 7947 7948 7949 7950 7951 7952 7953 7954 7955 7956 7957 7958 7959
	7960 7961 7962 7963 7964 7965 7966 7967 7968 7969 7970 7971 7972 7973 7974
	#Andaman Islands
	7866 7867 7868 7869 7870 7871 7872 7873 7874 7875
	#Africa
	921 8020 8021 8022 8023 8024 8025 8026 8027 8028 8029 8030 8031 8032 8033 8034 8035 8036 8037 8038 8039 8040 8041 8042 8043
	8044 8045 8046 8047 8048 8049 8050 8051 8052 8053 8054 8055 8056 8057 8058 8059 8060 8061 8062 8063 8064 8065 8066 8067 8088
	8089 8148 8149 8150
}



